s:2
p:()
c:[]
x:++
w:==
<
==,==,==,==,==,==,==
==,(),  ,  ,  ,  ,==
==,  ,  ,  ,  ,  ,==
==,  ,++,[],  ,  ,==
==,  ,  ,  ,  ,  ,==
==,  ,  ,  ,  ,  ,==
==,==,==,==,==,==,==

